You wake up, dazed, in what appears to be a shady forest. A thick blanket of fog slowly rolls in from all directions, restricting your vision for more than around twenty feet in any direction. You struggle to recall how you ended up in this forest, but all you can remember is stepping into a curious circle of mushrooms in your backyard before waking up here. Maybe you should look around for that mushroom ring...

You gather your courage and slowly stand up.

Fairy Ring
An Interactive Fiction by Austin Gill
Release 1 / Serial number 110921 / Inform 7 build 6G60 (I6/v6.32 lib 6/12N) SD

Foggy Clearing
This is the shady clearing you first woke up in. The white fog still appears to be rolling in steadily. There is a towering tree in the middle of the clearing. It looks like there are some firm branches you could use to climb it. The forest appears to continue both to the east and to the west.

Below the towering tree lies a simple pile of leaves. There is also a strange ring of mushrooms growing in the grass.

>west
Whistling Grove
Odd trees with crescent-shaped trunks fill the grove. A small pile of twigs lies at the foot of one of the trees. There also appears to be a strange indent carved into the largest tree.

>x pile
At first glance, simply a pile of twigs.

In the pile of twigs you find an acorn. You take it for safekeeping.

>x indent
A small hole carved into the side of the largest tree.

You also see an intense light emanating from a bright marble within the indent.

>take bright marble
Taken.

>east
Foggy Clearing
This is the shady clearing you first woke up in. The white fog still appears to be rolling in steadily. There is a towering tree in the middle of the clearing. It seems almost mystical by nature. The forest appears to continue both to the east and to the west.

Below it lies a simple pile of leaves. There is also a strange ring of mushrooms growing in the grass.

>east
Quiet Thicket
A tranquil river flows slowly from a dark cave to the north toward a distant waterfall to the south. Several willow trees crowd the thicket, drooping toward the damp grass sadly. A hollow fallen oak tree also lays broken against the edge of the river.

You can see a squirrel here.

>give acorn to squirrel
The fuzzy squirrel snatches the acorn from your hand and eagerly stuffs it into its cheek. It darts quickly into the fallen oak tree nearby and returns seconds later with a small red mushroom.

You take the small red mushroom from the squirrel and gently pat it on the head.

>north
Spooky Cave
The radiance of your glowing marble lights the abysmal cave. The cave emits the soft crunches of your footsteps as you walk across some scattered grains of sand. The river appears to originate from a large rocky outcrop at the bottom of a shallow pool of water.

>push jagged rock
With great effort, you push the jagged rock over in the water, revealing the small green mushroom beneath it.

>take mushroom
(the small green mushroom)
Taken.

>south
Quiet Thicket
A tranquil river flows slowly from a dark cave to the north toward a distant waterfall to the south. Several willow trees crowd the thicket, drooping toward the damp grass sadly. A hollow fallen oak tree also lays broken against the edge of the river.

You can see a squirrel here.

>south
Beneath The Rainbow
You walk along the river to be met with a glorious rainbow at the edge of the waterfall. It shimmers with cool mist from the crashing waterfall.

You can see eagles here.

>whistle eagles
The black eagle floats leisurely towards you, letting out a friendly screech before carefully dropping a small yellow mushroom in your outstretched palm.

You place the small yellow mushroom in your bag.

>north
Quiet Thicket
A tranquil river flows slowly from a dark cave to the north toward a distant waterfall to the south. Several willow trees crowd the thicket, drooping toward the damp grass sadly. A hollow fallen oak tree also lays broken against the edge of the river.

You can see a squirrel here.

>west
Foggy Clearing
This is the shady clearing you first woke up in. The white fog still appears to be rolling in steadily. There is a towering tree in the middle of the clearing. It seems almost mystical by nature. The forest appears to continue both to the east and to the west.

Below it lies a simple pile of leaves. There is also a strange ring of mushrooms growing in the grass.

>put mushrooms in mushroom ring
You should probably try to put them in one by one.

>put mushroom in mushroom ring
Which do you mean, the small yellow mushroom, the small green mushroom, the small red mushroom or the ring of mushrooms?

>yellow
You put the small yellow mushroom into the ring of mushrooms.

[Your score has just gone up by one point.]

>put mushroom in mushroom ring
Which do you mean, the small green mushroom, the small red mushroom, the ring of mushrooms or the small yellow mushroom?

>red
You put the small red mushroom into the ring of mushrooms.

[Your score has just gone up by one point.]

>up
Top of Towering Tree
You teeter precariously on a thin branch at the top of the towering tree. Despite how high you are, you can't see much else besides other tree tops through the thick fog.

To the left of you is a crooked branch just barely within arm's reach.

>x crooked
A small, crooked tree branch. On its end grows a small blue mushroom. How peculiar.

>take mushroom
(the small blue mushroom)
Oops. The mushroom just barely slips out of your grasp, falling gently through the fog and out of sight.

>down
Foggy Clearing
This is the shady clearing you first woke up in. The white fog still appears to be rolling in steadily. There is a towering tree in the middle of the clearing. It seems almost mystical by nature. The forest appears to continue both to the east and to the west.

Below it lies a simple pile of leaves. There is also a strange ring of mushrooms growing in the grass.

>x pile
A pile of nondescript leaves.

In the pile of leaves is a small blue mushroom.

>take mushroom
Which do you mean, the ring of mushrooms, the small red mushroom, the small yellow mushroom, the small blue mushroom or the small green mushroom?

>blue
 Taken.

The blue mushroom reminds you of the mushroom ring you saw in your backyard before ending up in this forest. Perhaps there's a connection?

>put blue mushroom in ring of mushrooms
You put the small blue mushroom into the ring of mushrooms.

[Your score has just gone up by one point.]

>x ring of mushrooms
The mushrooms on the grass are growing in an uncanny circle. They appear to follow some sort of color pattern. It seems that the mushroom ring needs a blue, red, green, and yellow mushroom to be complete. If you find any mushrooms, you should probably put them in the ring.

In the ring of mushrooms are a small blue mushroom, a small red mushroom and a small yellow mushroom.

>put green mushroom in ring of mushrooms
You put the small green mushroom into the ring of mushrooms.

The ring of mushrooms shimmers with a mystical white aura as the surrounding fog slowly dissipates. As the fog clears, you find yourself once again within the mushroom circle in your backyard.

    *** You have won ***

In that game you scored 4 out of a possible 0, in 27 turns.

Would you like to RESTART, RESTORE a saved game, QUIT or UNDO the last command?

* * *

>west
Whistling Grove
Odd trees with crescent-shaped trunks fill the grove. A small pile of twigs lies at the foot of one of the trees. There also appears to be a strange indent carved into the largest tree.

>climb tree
I don't think much is to be achieved by that.

* * *

>up
Top of Towering Tree
You teeter precariously on a thin branch at the top of the towering tree. Despite how high you are, you can't see much else besides other tree tops through the thick fog.

To the left of you is a crooked branch just barely within arm's reach.

>up
You can't go that way.

>climb down
Foggy Clearing
This is the shady clearing you first woke up in. The white fog still appears to be rolling in steadily. There is a towering tree in the middle of the clearing. It seems almost mystical by nature. The forest appears to continue both to the east and to the west.

Below it lies a simple pile of leaves. There is also a strange ring of mushrooms growing in the grass.

>up
Top of Towering Tree
You teeter precariously on a thin branch at the top of the towering tree. Despite how high you are, you can't see much else besides other tree tops through the thick fog.

To the left of you is a crooked branch just barely within arm's reach.

>climb down tree
I only understood you as far as wanting to climb down.

* * *

>up
Top of Towering Tree
You teeter precariously on a thin branch at the top of the towering tree. Despite how high you are, you can't see much else besides other tree tops through the thick fog.

To the left of you is a crooked branch just barely within arm's reach.

>examine crooked branch
A small, crooked tree branch. On its end grows a small blue mushroom. How peculiar.

>take blue mushroom
Oops. The mushroom just barely slips out of your grasp, falling gently through the fog and out of sight.

>down
Foggy Clearing
This is the shady clearing you first woke up in. The white fog still appears to be rolling in steadily. The forest appears to continue both east and west. There is a towering tree in the middle of the clearing. It seems almost mystical by nature.

Below it lies a simple pile of leaves. There is also a strange ring of mushrooms growing in the grass.

>x pile of leaves
A pile of nondescript leaves.

In the pile of leaves is a small blue mushroom.

>take blue mushroom
 Taken.

The blue mushroom reminds you of the mushroom ring you saw in your backyard before ending up in this forest. Perhaps there's a connection?

>east
Quiet Thicket
A tranquil river flows slowly from a dark cave to the north toward a distant waterfall to the south. Several willow trees crowd the thicket, drooping toward the damp grass sadly. A hollow fallen oak tree also lays broken against the edge of the river.

>x hollow fallen oak
In the hollow fallen oak tree is a small red mushroom.

>take red mushroom
You try to squeeze your arm through the hole in the fallen oak tree, but fail to reach the mushroom.

>enter hollow fallen oak tree
You're far too big to fit in the tree. You can see a small red mushroom peeking out at you on the far inside of the tree.

>eat small red mushroom
(first taking the small red mushroom)
You try to squeeze your arm through the hole in the fallen oak tree, but fail to reach the mushroom.

>south
Beneath The Rainbow
You walk along the river to be met with a glorious rainbow at the edge of the waterfall. It shimmers with cool mist from the crashing waterfall. Majestic eagles can be seen flying nearby.

You can see eagles here.

>examine eagles
These majestic birds fly through the fine mist of the waterfall. A large black eagle appears to be carrying a small yellow object. Perhaps you should whistle at the eagle to get its attention?

>whistle at eagle
The black eagle floats leisurely towards you, letting out a friendly screech before carefully dropping a small yellow mushroom in your outstretched palm. You place the mushroom into your bag.

>i
You are carrying:
  a small yellow mushroom
  a small blue mushroom

* * *

>climb tree
Top of Towering Tree
You teeter precariously on a thin branch at the top of the towering tree. Despite how high you are, you can't see much else besides other tree tops through the thick fog. To the left of you is a crooked branch just barely within arm's reach.

>restart
Are you sure you want to restart?

* * *

>examine leaves
A pile of nondescript leaves.

>examine mushrooms
The mushrooms on the grass are growing in an uncanny circle. They appear to follow some sort of color pattern. It seems that the mushroom ring needs a blue, red, green, and yellow mushroom to be complete. If you find any mushrooms, you should probably put them in the ring.

>walk east
Quiet Thicket
A tranquil river flows slowly from a dark cave to the north toward a distant waterfall to the south. Several willow trees crowd the thicket, drooping toward the damp grass sadly. A hollow fallen oak tree also lays broken against the edge of the river.

You can see a squirrel here.

>examine oak tree
In the hollow fallen oak tree is a small red mushroom.

>examine mushroom
A vibrant red mushroom. It resonates with a warm glow.

>take mushroom
You try to squeeze your arm through the hole in the fallen oak tree, but fail to reach the mushroom.

>examine squirrel
The fuzzy squirrel seems very interested in you. It rubs its stomach tirelessly. Maybe it's hungry?

>talk to squirrel
That's not a verb I recognise.

>take squirrel
I don't suppose the squirrel would care for that.

>walk north
Darkness
It is pitch dark, and you can't see a thing.

>walk south
Quiet Thicket
A tranquil river flows slowly from a dark cave to the north toward a distant waterfall to the south. Several willow trees crowd the thicket, drooping toward the damp grass sadly. A hollow fallen oak tree also lays broken against the edge of the river.

You can see a squirrel here.

>walk south
Beneath The Rainbow
You walk along the river to be met with a glorious rainbow at the edge of the waterfall. It shimmers with cool mist from the crashing waterfall.

You can see eagles here.

>examine rainbow
A magnificent rainbow shines in the sky above you. It's definitely a nice change of pace from the melancholy fog.

>examine eagles
These majestic birds fly through the fine mist of the waterfall. A large black eagle appears to be carrying a small yellow object. Perhaps you should whistle at the eagle to get its attention?

>whistle at eagle
The black eagle floats leisurely towards you, letting out a friendly screech before carefully dropping a small yellow mushroom in your outstretched palm.

You place the small yellow mushroom in your bag.

>examine yellow mushroom
(the small yellow mushroom)
A small yellow mushroom. It shines with a light reminiscent of the rainbow it honored.

>take mushroom
(eagles)
I don't suppose eagles would care for that.

>walk north
Quiet Thicket
A tranquil river flows slowly from a dark cave to the north toward a distant waterfall to the south. Several willow trees crowd the thicket, drooping toward the damp grass sadly. A hollow fallen oak tree also lays broken against the edge of the river.

You can see a squirrel here.

>walk west
Foggy Clearing
This is the shady clearing you first woke up in. The white fog still appears to be rolling in steadily. There is a towering tree in the middle of the clearing. It seems almost mystical by nature. The forest appears to continue both to the east and to the west.

Below it lies a simple pile of leaves. There is also a strange ring of mushrooms growing in the grass.

>walk west
Whistling Grove
Odd trees with crescent-shaped trunks fill the grove. A small pile of twigs lies at the foot of one of the trees. There also appears to be a strange indent carved into the largest tree.

>examine pile
At first glance, simply a pile of twigs.

In the pile of twigs you find an acorn. You take it for safekeeping.

>take acorn
You already have that.

>examine largest tree
A tree, shaped like a lunar crescent. This one is definitely the biggest of the bunch.

>examine indent
A small hole carved into the side of the largest tree.

You also see an intense light emanating from a bright marble within the indent.

>walk west
You can't go that way.

>examine light
You can't see any such thing.

>look inside hole
In the strange indent is a bright marble.

>examine marble
You can barely look at the shining marble for more than a few seconds before averting your eyes.

>take marble
Taken.

>walk east
Foggy Clearing
This is the shady clearing you first woke up in. The white fog still appears to be rolling in steadily. There is a towering tree in the middle of the clearing. It seems almost mystical by nature. The forest appears to continue both to the east and to the west.

Below it lies a simple pile of leaves. There is also a strange ring of mushrooms growing in the grass.

>walk east
Quiet Thicket
A tranquil river flows slowly from a dark cave to the north toward a distant waterfall to the south. Several willow trees crowd the thicket, drooping toward the damp grass sadly. A hollow fallen oak tree also lays broken against the edge of the river.

You can see a squirrel here.

>walk west
Foggy Clearing
This is the shady clearing you first woke up in. The white fog still appears to be rolling in steadily. There is a towering tree in the middle of the clearing. It seems almost mystical by nature. The forest appears to continue both to the east and to the west.

Below it lies a simple pile of leaves. There is also a strange ring of mushrooms growing in the grass.

>examine mushroom
(the small yellow mushroom)
A small yellow mushroom. It shines with a light reminiscent of the rainbow it honored.

>examine ring
The mushrooms on the grass are growing in an uncanny circle. They appear to follow some sort of color pattern. It seems that the mushroom ring needs a blue, red, green, and yellow mushroom to be complete. If you find any mushrooms, you should probably put them in the ring.

>take mushroom
(the small yellow mushroom)
You already have that.

>examine pile
A pile of nondescript leaves.

>walk east
Quiet Thicket
A tranquil river flows slowly from a dark cave to the north toward a distant waterfall to the south. Several willow trees crowd the thicket, drooping toward the damp grass sadly. A hollow fallen oak tree also lays broken against the edge of the river.

You can see a squirrel here.

* * *

>examine oak tree
In the hollow fallen oak tree is a small red mushroom.

>take red mushroom
You try to squeeze your arm through the hole in the fallen oak tree, but fail to reach the mushroom.

>give squirrel acorn
The fuzzy squirrel snatches the acorn from your hand and eagerly stuffs it into its cheek. It darts quickly into the fallen oak tree nearby and returns seconds later with a small red mushroom.

You take the small red mushroom from the squirrel and gently pat it on the head.

>walk east
You can't go that way.

>walknorth
That's not a verb I recognise.

>north
Spooky Cave
The radiance of your glowing marble lights the abysmal cave. The cave emits the soft crunches of your footsteps as you walk across some scattered grains of sand. The river appears to originate from a large rocky outcrop at the bottom of a shallow pool of water.

>examine outcrop
Many large boulders lie here at the bottom of the shallow pool. One jagged rock in particular stands out. You could probably push it aside.

>push rock aside
You can't see any such thing.

>move rock
With great effort, you push the jagged rock over in the water, revealing the small green mushroom beneath it.

>examine green mushroom
An emerald green mushroom. It appears to have spent quite some time between a rock and a hard place.

>take green mushroom
Taken.

>walk south
Quiet Thicket
A tranquil river flows slowly from a dark cave to the north toward a distant waterfall to the south. Several willow trees crowd the thicket, drooping toward the damp grass sadly. A hollow fallen oak tree also lays broken against the edge of the river.

You can see a squirrel here.

* * *

>examine rainbow
A magnificent rainbow shines in the sky above you. It's definitely a nice change of pace from the melancholy fog.

>examine waterfall
The impressive finale of the tranquil river's life. It crashes below in thunderous applause.

>walk north
Quiet Thicket
A tranquil river flows slowly from a dark cave to the north toward a distant waterfall to the south. Several willow trees crowd the thicket, drooping toward the damp grass sadly. A hollow fallen oak tree also lays broken against the edge of the river.

You can see a squirrel here.

>walk north
Spooky Cave
The radiance of your glowing marble lights the abysmal cave. The cave emits the soft crunches of your footsteps as you walk across some scattered grains of sand. The river appears to originate from a large rocky outcrop at the bottom of a shallow pool of water.

>examine poolk
You can't see any such thing.

>examine pool
Chilly.

>examine sand
Small specks of sand litter the cave floor. Who knows how they could have gotten there?

>walk south
Quiet Thicket
A tranquil river flows slowly from a dark cave to the north toward a distant waterfall to the south. Several willow trees crowd the thicket, drooping toward the damp grass sadly. A hollow fallen oak tree also lays broken against the edge of the river.

You can see a squirrel here.

>walk west
Foggy Clearing
This is the shady clearing you first woke up in. The white fog still appears to be rolling in steadily. There is a towering tree in the middle of the clearing. It seems almost mystical by nature. The forest appears to continue both to the east and to the west.

Below it lies a simple pile of leaves. There is also a strange ring of mushrooms growing in the grass.

* * *

>walk west
Whistling Grove
Odd trees with crescent-shaped trunks fill the grove. A small pile of twigs lies at the foot of one of the trees. There also appears to be a strange indent carved into the largest tree.

>examine indent
A small hole carved into the side of the largest tree.

>climb tree
I don't think much is to be achieved by that.

>walk east
Foggy Clearing
This is the shady clearing you first woke up in. The white fog still appears to be rolling in steadily. There is a towering tree in the middle of the clearing. It seems almost mystical by nature. The forest appears to continue both to the east and to the west.

Below it lies a simple pile of leaves. There is also a strange ring of mushrooms growing in the grass.

>examine tall tree
You can't see any such thing.

>examine towering tree
A gnarled, aged tree. You could probably climb this fairly easily.

>climb tree
Top of Towering Tree
You teeter precariously on a thin branch at the top of the towering tree. Despite how high you are, you can't see much else besides other tree tops through the thick fog.

To the left of you is a crooked branch just barely within arm's reach.

>examine crooked branch
A small, crooked tree branch. On its end grows a small blue mushroom. How peculiar.

>examine blue mushrooom
I only understood you as far as wanting to examine the small blue mushroom.

>take blue mushroom
Oops. The mushroom just barely slips out of your grasp, falling gently through the fog and out of sight.

>climb down tree
I only understood you as far as wanting to climb down.

>climb down
You must name something more substantial.

>down
Foggy Clearing
This is the shady clearing you first woke up in. The white fog still appears to be rolling in steadily. There is a towering tree in the middle of the clearing. It seems almost mystical by nature. The forest appears to continue both to the east and to the west.

Below it lies a simple pile of leaves. There is also a strange ring of mushrooms growing in the grass.

>examine leaves
A pile of nondescript leaves.

In the pile of leaves is a small blue mushroom.

>take blue mushroom
 Taken.

The blue mushroom reminds you of the mushroom ring you saw in your backyard before ending up in this forest. Perhaps there's a connection?

>walk west
Whistling Grove
Odd trees with crescent-shaped trunks fill the grove. A small pile of twigs lies at the foot of one of the trees. There also appears to be a strange indent carved into the largest tree.

>walk east
Foggy Clearing
This is the shady clearing you first woke up in. The white fog still appears to be rolling in steadily. There is a towering tree in the middle of the clearing. It seems almost mystical by nature. The forest appears to continue both to the east and to the west.

Below it lies a simple pile of leaves. There is also a strange ring of mushrooms growing in the grass.

* * *

>walk west
Foggy Clearing
This is the shady clearing you first woke up in. The white fog still appears to be rolling in steadily. There is a towering tree in the middle of the clearing. It seems almost mystical by nature. The forest appears to continue both to the east and to the west.

Below it lies a simple pile of leaves. There is also a strange ring of mushrooms growing in the grass.

>walk east
Quiet Thicket
A tranquil river flows slowly from a dark cave to the north toward a distant waterfall to the south. Several willow trees crowd the thicket, drooping toward the damp grass sadly. A hollow fallen oak tree also lays broken against the edge of the river.

You can see a squirrel here.

>walk east
You can't go that way.

>walk west
Foggy Clearing
This is the shady clearing you first woke up in. The white fog still appears to be rolling in steadily. There is a towering tree in the middle of the clearing. It seems almost mystical by nature. The forest appears to continue both to the east and to the west.

Below it lies a simple pile of leaves. There is also a strange ring of mushrooms growing in the grass.

>examine ring
The mushrooms on the grass are growing in an uncanny circle. They appear to follow some sort of color pattern. It seems that the mushroom ring needs a blue, red, green, and yellow mushroom to be complete. If you find any mushrooms, you should probably put them in the ring.

>put mushrooms in ring
(first taking the ring of mushrooms)

That's hardly portable.

>put red mushroom in ring
You put the small red mushroom into the ring of mushrooms.

[Your score has just gone up by one point.]

>put blue mushroom in ring
You put the small blue mushroom into the ring of mushrooms.

[Your score has just gone up by one point.]

>put green mushroom in ring
You put the small green mushroom into the ring of mushrooms.

[Your score has just gone up by one point.]

>put yellow mushroom in ring
You put the small yellow mushroom into the ring of mushrooms.

The ring of mushrooms shimmers with a mystical white aura as the surrounding fog slowly dissipates. As the fog clears, you find yourself once again within the mushroom circle in your backyard.

    *** You have won ***

In that game you scored 4 out of a possible 0, in 79 turns.

Would you like to RESTART, RESTORE a saved game, QUIT or UNDO the last command?

* * *

>x grass
It's grass. What did you expect?

* * *

>east
Quiet Thicket
A tranquil river flows slowly from a dark cave to the north toward a distant waterfall to the south. Several willow trees crowd the thicket, drooping toward the damp grass sadly. A hollow fallen oak tree also lays broken against the edge of the river.

You can see a squirrel here.

>north
Darkness
It is pitch dark, and you can't see a thing.

>south
Quiet Thicket
A tranquil river flows slowly from a dark cave to the north toward a distant waterfall to the south. Several willow trees crowd the thicket, drooping toward the damp grass sadly. A hollow fallen oak tree also lays broken against the edge of the river.

You can see a squirrel here.

>west
Foggy Clearing
This is the shady clearing you first woke up in. The white fog still appears to be rolling in steadily. The forest appears to continue both east and west. There is a towering tree in the middle of the clearing. It seems almost mystical by nature.

Below it lies a simple pile of leaves. There is also a strange ring of mushrooms growing in the grass.

>west
Whistling Grove
Odd trees with crescent-shaped trunks fill the grove. A small pile of twigs lies at the foot of one of the trees. There also appears to be a strange indent carved into the largest tree.

>take bright marble
You can't see any such thing.

>x strange indent
A small hole carved into the side of the largest tree.

You also see an intense light emanating from a bright marble within the indent.

>take bright marble
Taken.

>x strange indent
A small hole carved into the side of the largest tree.

>east
Foggy Clearing
This is the shady clearing you first woke up in. The white fog still appears to be rolling in steadily. The forest appears to continue both east and west. There is a towering tree in the middle of the clearing. It seems almost mystical by nature.

Below it lies a simple pile of leaves. There is also a strange ring of mushrooms growing in the grass.

>east
Quiet Thicket
A tranquil river flows slowly from a dark cave to the north toward a distant waterfall to the south. Several willow trees crowd the thicket, drooping toward the damp grass sadly. A hollow fallen oak tree also lays broken against the edge of the river.

You can see a squirrel here.

>north
Spooky Cave
The radiance of your glowing marble lights the abysmal cave. The cave emits the soft crunches of your footsteps as you walk across some scattered grains of sand. The river appears to originate from a large rocky outcrop at the bottom of a shallow pool of water.

>south
Quiet Thicket
A tranquil river flows slowly from a dark cave to the north toward a distant waterfall to the south. Several willow trees crowd the thicket, drooping toward the damp grass sadly. A hollow fallen oak tree also lays broken against the edge of the river.

You can see a squirrel here.

* * *

>west
Whistling Grove
Odd trees with crescent-shaped trunks fill the grove. A small pile of twigs lies at the foot of one of the trees. There also appears to be a strange indent carved into the largest tree.

>x pile of twigs
At first glance, simply a pile of twigs.

In the pile of twigs you find an acorn. You take it for safekeeping.

>east
Foggy Clearing
This is the shady clearing you first woke up in. The white fog still appears to be rolling in steadily. The forest appears to continue both east and west. There is a towering tree in the middle of the clearing. It seems almost mystical by nature.

Below it lies a simple pile of leaves. There is also a strange ring of mushrooms growing in the grass.

* * *

>east
Quiet Thicket
A tranquil river flows slowly from a dark cave to the north toward a distant waterfall to the south. Several willow trees crowd the thicket, drooping toward the damp grass sadly. A hollow fallen oak tree also lays broken against the edge of the river.

You can see a squirrel here.

>give acorn to squirrel
The squirrel doesn't seem interested.

* * *

>north
Darkness
It is pitch dark, and you can't see a thing.

>swim
You get into the pool of water.

>examine rocky outcrop
Many large boulders lie here at the bottom of the shallow pool. One jagged rock in particular stands out. You could probably push it aside.

>examine rocky outcrop
Many large boulders lie here at the bottom of the shallow pool. One jagged rock in particular stands out. You could probably push it aside.

>push jagged rock
With great effort, you push the jagged rock over in the water, revealing the small green mushroom beneath it.

>examine pool of water
Chilly.

>look
Spooky Cave (in the pool of water)
The radiance of your glowing bauble lights the abysmal cave. The cave emits the soft crunches of your footsteps as you walk across some scattered grains of sand. The river appears to originate from a large rocky outcrop at the bottom of a shallow pool of water.

>take small green mushroom
Taken.

>get out
You get out of the pool of water.

Spooky Cave
The radiance of your glowing bauble lights the abysmal cave. The cave emits the soft crunches of your footsteps as you walk across some scattered grains of sand. The river appears to originate from a large rocky outcrop at the bottom of a shallow pool of water.

>x outcrop
Many large boulders lie here at the bottom of the shallow pool. One jagged rock in particular stands out. You could probably push it aside.

>south
Quiet Thicket
A tranquil river flows slowly from a dark cave to the north toward a distant waterfall to the south. Several willow trees crowd the thicket, drooping toward the damp grass sadly. A hollow fallen oak tree also lays broken against the edge of the river.

>x fallen oak
In the hollow fallen oak tree is a small red mushroom.

>west
Foggy Clearing
This is the shady clearing you first woke up in. The white fog still appears to be rolling in steadily. The forest appears to continue both east and west. There is a towering tree in the middle of the clearing. It seems almost mystical by nature.

Below it lies a simple pile of leaves. There is also a strange ring of mushrooms growing in the grass.

>x leaves
A pile of nondescript leaves.

>i
You are carrying:
  a small green mushroom

* * *

>east
Quiet Thicket
A tranquil river flows slowly from a dark cave to the north toward a distant waterfall to the south. Several willow trees crowd the thicket, drooping toward the damp grass sadly. A hollow fallen oak tree also lays broken against the edge of the river.

You can see a squirrel here.

>south
Beneath The Rainbow
You walk along the river to be met with a glorious rainbow at the edge of the waterfall. It shimmers with cool mist from the crashing waterfall. Majestic eagles can be seen flying nearby.

You can see eagles here.

>take eagles
I don't suppose eagles would care for that.

>talk eagles
That's not a verb I recognise.

>talk to eagles
That's not a verb I recognise.

>give mushroom to eagles
(first taking eagles)
I don't suppose eagles would care for that.

>i
You are carrying nothing.

* * *

>east
Quiet Thicket
A tranquil river flows slowly from a dark cave to the north toward a distant waterfall to the south. Several willow trees crowd the thicket, drooping toward the damp grass sadly. A hollow fallen oak tree also lays broken against the edge of the river.

You can see a squirrel here.

>s
Beneath The Rainbow
You walk along the river to be met with a glorious rainbow at the edge of the waterfall. It shimmers with cool mist from the crashing waterfall.

You can see eagles here.

>x eagles
These majestic birds fly through the fine mist of the waterfall. A large black eagle appears to be carrying a small yellow object. Perhaps you should whistle at the eagle to get its attention?

>whistle to eagle
The black eagle floats leisurely towards you, letting out a friendly screech before carefully dropping a small yellow mushroom in your outstretched palm.

You place the small yellow mushroom in your bag.

>n
Quiet Thicket
A tranquil river flows slowly from a dark cave to the north toward a distant waterfall to the south. Several willow trees crowd the thicket, drooping toward the damp grass sadly. A hollow fallen oak tree also lays broken against the edge of the river.

You can see a squirrel here.

>n
Darkness
It is pitch dark, and you can't see a thing.

>s
Quiet Thicket
A tranquil river flows slowly from a dark cave to the north toward a distant waterfall to the south. Several willow trees crowd the thicket, drooping toward the damp grass sadly. A hollow fallen oak tree also lays broken against the edge of the river.

You can see a squirrel here.

>w
Foggy Clearing
This is the shady clearing you first woke up in. The white fog still appears to be rolling in steadily. There is a towering tree in the middle of the clearing. It seems almost mystical by nature. The forest appears to continue both to the east and to the west.

Below it lies a simple pile of leaves. There is also a strange ring of mushrooms growing in the grass.

* * *

>climb
What do you want to climb?

>tree
compass (5) 
  the north
  the northeast
  the northwest
  the south
  the southeast
  the southwest
  the east
  the west
  the up
  the down
  the inside
  the outside
(LibraryMessages) (6) 
(darkness object) (7) 
(Inform Parser) (8) 
(Inform Library) (9) 
(property_numberspace_forcer) (10) 
(ValuePropertyHolder_39) (12) 
Foggy Clearing (42) 
  yourself
  white fog
  a ring of mushrooms
  grass
  a pile of leaves
  a filing cabinet (closed and locked)
  a towering tree
Top of Towering Tree (49) 
  a thin branch
  a crooked branch
  tree tops
  thick fog
small blue mushroom (54) 
Quiet Thicket (55) 
  a squirrel
  damp grass
  willow trees
  edge of the river
  a dark cave
  tranquil river
  distant waterfall
  a hollow fallen oak tree
    a small red mushroom
Spooky Cave (65) 
  scattered grains of sand
  creepy river
  large rocky outcrop
  jagged rock
  a pool of water
small green mushroom (71) 
Beneath The Rainbow (72) 
  boys river
  lolol rainbow
  omgz waterfall
  mist
  eagles
small yellow mushroom (78) 
Whistling Grove (79) 
  a weird trees
  a pile of twigs
  a strange indent
  a largest tree
bright marble (84) 
acorn (85)

>restart
Are you sure you want to restart?

* * *

>climb tree
Top of Towering Tree
You teeter precariously on a thin branch at the top of the towering tree. Despite how high you are, you can't see much else besides other tree tops through the thick fog. To the left of you is a crooked branch just barely within arm's reach.

>examine crooked branch
A small, crooked tree branch. On its end grows a small blue mushroom. How peculiar.

>take mushroom
Oops. The mushroom just barely slips out of your grasp, falling gently through the fog and out of sight.

>down
Foggy Clearing
This is the shady clearing you first woke up in. The white fog still appears to be rolling in steadily. There is a towering tree in the middle of the clearing. It seems almost mystical by nature.

Below it lies a simple pile of leaves. There is also a strange ring of mushrooms growing in the grass.

>down
You can't go that way.

>x pile of leaves
A pile of nondescript leaves.

In the pile of leaves is a blue mushroom.

>take blue mushroom
 Taken.

The blue mushroom reminds you of the mushroom ring you saw in your backyard before ending up in this forest. Perhaps there's a connection?

    *** You have won ***

In that game you scored 0 out of a possible 0, in 7 turns.

Would you like to RESTART, RESTORE a saved game, QUIT or UNDO the last command?